,0,1,2,3,4,5,6,7,8,9,10,11,12,13,14
A,3,0,4,0,1,1,0,0,0,3,1,2,0,0,1
C,0,0,0,0,0,0,0,0,0,0,0,0,1,0,0
D,0,4,2,4,1,0,1,0,0,1,0,0,0,1,0
E,0,0,1,4,1,4,0,0,0,0,0,0,0,0,0
F,0,0,0,0,0,0,0,0,0,0,0,0,0,0,0
G,0,0,1,0,0,0,4,0,4,0,0,1,0,0,0
H,0,2,0,0,0,0,0,0,0,0,0,0,0,0,0
I,1,0,0,0,0,0,0,0,0,0,0,0,0,0,0
K,0,0,0,0,0,0,1,0,0,0,1,0,0,1,0
L,1,0,0,0,1,0,0,0,0,0,0,0,0,0,0
M,0,0,0,0,4,0,4,0,1,0,0,0,1,0,0
N,0,0,0,0,0,0,0,0,0,0,0,0,0,0,0
P,0,0,0,0,0,0,0,0,0,0,0,0,0,0,1
Q,0,2,0,0,0,0,0,0,0,0,0,0,0,0,0
R,4,0,0,0,0,0,0,0,0,0,0,4,0,4,4
S,0,1,1,1,1,0,0,1,0,0,0,0,0,0,0
T,1,0,1,0,0,4,0,5,0,0,4,1,4,0,0
V,0,1,0,0,1,1,0,0,5,2,4,2,0,0,0
W,0,0,0,0,0,0,0,0,0,0,0,0,4,0,4
Y,0,0,0,1,0,0,0,4,0,4,0,0,0,4,0
