,0,1,2,3,4,5,6,7,8,9,10,11,12,13,14
A,0,0,0,0,0,1,0,0,0,2,1,0,0,0,1
C,0,1,0,0,0,0,0,0,0,0,0,0,1,0,0
D,0,1,2,0,0,0,1,0,0,1,0,1,0,1,0
E,0,0,0,0,0,0,0,0,0,1,0,0,0,0,1
F,0,0,0,0,0,1,0,0,0,0,0,0,0,0,0
G,0,0,1,1,0,0,1,0,0,0,0,1,0,0,0
H,0,0,0,0,0,0,0,0,0,0,0,0,0,0,0
I,1,0,0,0,1,0,0,0,2,0,0,0,0,0,0
K,0,0,0,1,1,0,1,0,0,0,1,0,0,0,0
L,1,0,0,0,2,1,1,0,0,0,2,1,0,0,1
M,0,1,0,0,0,0,0,0,0,0,0,0,0,0,0
N,0,0,0,0,0,0,0,0,0,0,0,0,1,0,0
P,1,0,1,0,1,0,0,0,1,0,0,0,1,2,1
Q,1,0,0,2,0,0,0,0,0,0,0,0,0,0,0
R,0,0,0,0,0,1,1,0,1,0,0,0,1,1,0
S,1,1,0,1,0,0,0,3,0,1,0,0,1,1,0
T,0,0,0,0,0,0,0,2,0,0,0,2,0,0,1
V,0,1,0,0,0,1,0,0,1,0,0,0,0,0,0
W,0,0,0,0,0,0,0,0,0,0,0,0,0,0,0
Y,0,0,1,0,0,0,0,0,0,0,1,0,0,0,0
