,0,1,2,3,4,5,6,7,8,9,10,11,12,13,14
A,3,0,2,0,1,1,1,0,0,1,0,0,0,0,0
C,0,1,0,0,0,0,0,0,0,0,0,0,0,0,0
D,0,1,0,1,0,0,0,0,1,0,1,1,0,1,2
E,0,0,1,1,0,2,0,0,0,0,0,0,0,0,0
F,0,0,2,0,2,0,0,0,0,0,0,0,0,0,0
G,0,1,0,0,1,0,1,0,1,0,0,0,0,0,0
H,0,1,0,0,0,0,0,0,0,0,0,0,0,0,0
I,0,0,0,0,0,0,0,0,0,0,0,0,0,0,0
K,0,0,0,0,0,0,0,0,0,0,0,0,0,0,0
L,0,0,0,0,0,1,0,0,1,0,0,0,0,1,0
M,0,0,1,2,3,2,4,0,0,1,0,0,0,0,0
N,0,2,0,1,0,0,0,0,0,0,0,0,1,0,0
P,0,0,0,0,0,0,2,0,3,0,0,0,0,0,0
Q,1,0,0,1,0,0,1,0,0,0,0,0,0,0,0
R,1,0,1,0,0,0,0,0,0,0,0,3,0,3,3
S,2,2,0,3,0,0,0,2,0,0,2,1,1,1,1
T,2,1,2,0,2,3,0,4,0,1,3,0,4,0,0
V,0,0,0,0,0,0,0,0,3,3,3,3,0,0,0
W,0,0,0,0,0,0,0,0,0,0,0,1,1,0,1
Y,0,0,0,0,0,0,0,3,0,3,0,0,2,3,2
