,0,1,2,3,4,5,6,7,8,9,10,11,12,13,14
A,0,0,0,1,0,0,1,0,0,2,3,1,2,1,0
C,0,0,0,0,0,0,0,0,0,1,0,0,0,1,0
D,1,1,0,1,0,0,1,0,0,0,0,0,0,1,1
E,1,0,2,2,0,0,1,0,1,0,0,1,3,0,2
F,1,0,0,1,0,1,0,0,0,0,0,0,0,0,0
G,0,2,1,1,1,0,0,0,0,0,0,0,0,0,0
H,2,1,1,0,0,0,0,0,0,0,0,0,0,0,0
I,0,0,0,0,0,0,0,0,1,0,0,1,2,1,0
K,0,0,0,0,0,0,0,0,0,0,0,0,0,0,0
L,0,1,0,0,1,2,4,0,1,1,0,3,0,0,1
M,0,0,0,1,0,0,0,0,0,1,0,0,0,1,0
N,0,0,1,0,1,0,1,0,0,0,0,0,0,0,0
P,1,1,0,1,1,0,0,0,3,1,1,0,0,1,1
Q,0,0,0,1,1,1,0,0,0,0,0,0,0,0,0
R,2,0,2,0,0,2,0,0,2,0,0,3,0,1,3
S,1,1,0,0,1,1,1,5,1,0,1,0,0,0,1
T,1,1,1,1,2,1,0,2,0,1,1,0,1,0,0
V,0,1,2,0,1,2,0,0,1,0,2,0,0,1,0
W,0,0,0,0,0,0,1,0,0,1,0,1,1,0,1
Y,0,1,0,0,1,0,0,3,0,2,2,0,1,2,0
