,0,1,2,3,4,5,6,7,8,9,10,11,12,13,14
A,0,0,1,0,0,2,0,0,0,1,2,0,1,1,2
C,0,1,0,0,0,0,0,0,0,0,0,1,1,0,0
D,0,0,1,0,0,0,1,0,0,0,0,0,0,0,2
E,1,0,1,1,0,0,0,0,0,0,0,1,1,0,0
F,0,0,0,0,0,1,0,0,0,0,1,0,0,0,0
G,0,1,1,0,1,0,0,0,0,1,0,1,0,0,0
H,0,0,0,1,0,0,0,0,0,0,0,0,0,0,0
I,1,0,0,0,0,0,0,0,0,0,0,1,0,0,0
K,0,0,0,0,1,0,1,0,1,0,1,0,0,0,0
L,1,0,0,0,2,0,1,0,0,1,0,0,1,0,0
M,1,0,0,0,0,0,1,0,0,1,0,0,0,0,0
N,0,1,0,0,0,0,0,0,0,0,0,0,1,0,0
P,1,1,1,1,1,3,0,0,5,0,1,1,0,2,0
Q,1,0,0,0,0,0,0,0,0,0,0,0,0,0,0
R,0,0,1,1,1,0,1,0,1,0,1,0,1,0,0
S,0,1,1,3,0,0,2,4,0,3,1,0,1,3,2
T,0,1,0,0,0,0,0,3,0,0,0,1,0,0,0
V,1,1,0,0,1,1,0,0,0,0,0,0,0,0,1
W,0,0,0,0,0,0,0,0,0,0,0,1,0,0,0
Y,0,0,0,0,0,0,0,0,0,0,0,0,0,1,0
