,0,1,2,3,4,5,6,7,8,9,10,11,12,13,14
A,0,0,0,0,0,1,1,0,0,2,2,0,0,1,1
C,0,1,0,0,0,0,1,0,0,1,0,0,1,0,0
D,1,2,2,0,2,0,1,0,0,1,0,1,1,1,0
E,0,0,1,0,0,0,0,0,0,1,0,1,0,0,2
F,1,0,0,0,1,1,0,0,0,0,1,0,0,1,0
G,1,2,3,2,1,2,1,0,1,1,1,2,2,0,0
H,0,0,1,0,0,0,1,0,0,0,1,0,0,0,0
I,1,0,1,0,1,0,1,0,2,0,1,0,0,1,0
K,0,0,1,0,0,0,1,0,0,0,1,0,0,1,0
L,1,2,0,0,2,1,0,0,0,0,0,1,0,0,1
M,1,1,1,0,0,2,0,0,0,0,0,0,1,0,0
N,0,0,0,0,0,0,1,0,0,1,0,1,1,0,0
P,2,0,0,0,3,3,2,0,5,4,2,0,3,4,2
Q,1,0,0,2,0,0,0,0,1,0,0,1,0,1,2
R,0,1,1,0,0,0,1,0,1,0,0,0,1,1,0
S,3,2,1,4,2,0,1,9,0,0,1,2,1,0,0
T,0,0,0,2,0,1,0,3,1,1,0,3,0,0,0
V,0,1,0,0,0,1,0,0,1,0,1,0,0,0,3
W,0,0,0,1,0,0,0,0,0,0,0,0,1,0,1
Y,0,0,0,1,0,0,0,0,0,0,1,0,0,1,0
