,0,1,2,3,4,5,6,7,8,9,10,11,12,13,14
A,1,0,0,0,0,0,0,0,0,1,0,1,0,0,0
C,0,0,0,0,2,0,0,0,0,0,0,0,0,0,0
D,0,1,1,1,1,0,0,0,0,0,0,0,0,0,0
E,0,0,0,1,0,1,2,0,0,0,0,0,0,0,0
F,0,0,1,0,1,0,0,0,2,0,0,0,0,0,0
G,2,1,0,0,0,0,1,0,1,0,2,0,0,0,0
H,0,1,0,0,0,0,0,0,0,0,0,0,0,0,0
I,0,2,0,0,0,0,0,0,0,0,0,0,0,0,0
K,0,0,0,0,0,0,0,0,0,0,0,0,0,0,0
L,0,0,0,0,0,0,0,0,0,0,0,0,2,0,0
M,0,0,0,1,2,1,2,0,0,0,0,0,0,0,0
N,0,0,1,0,0,0,0,0,0,0,0,0,0,0,0
P,0,0,0,2,0,0,1,0,1,0,0,0,0,0,0
Q,0,0,0,0,0,0,0,0,0,0,0,0,0,2,0
R,1,0,0,0,0,0,0,0,0,0,0,2,0,2,2
S,0,1,0,1,0,0,0,0,0,0,0,0,0,0,0
T,2,0,3,0,0,4,0,4,0,2,2,2,2,0,0
V,0,0,0,0,0,0,0,0,2,1,2,1,0,0,0
W,0,0,0,0,0,0,0,0,0,0,0,0,1,0,1
Y,0,0,0,0,0,0,0,2,0,2,0,0,1,2,3
