,0,1,2,3,4,5,6,7,8,9,10,11,12,13,14
A,1,1,2,2,3,3,4,0,2,2,2,1,2,2,2
C,1,0,0,2,0,0,0,0,0,2,0,0,1,0,0
D,2,4,4,3,4,1,2,0,2,4,4,3,3,2,0
E,0,0,0,2,0,0,1,0,3,1,0,1,1,1,3
F,3,0,0,0,1,3,1,0,1,0,0,0,2,2,0
G,2,2,4,2,2,1,3,0,1,1,6,5,1,2,3
H,2,0,0,2,1,1,1,0,2,0,1,1,0,1,1
I,3,0,4,0,2,4,2,0,4,0,0,2,2,1,1
K,1,3,0,2,5,1,1,0,2,3,2,1,3,2,4
L,3,1,7,1,1,1,2,0,2,3,0,5,3,3,0
M,1,1,1,0,0,2,1,0,0,1,0,1,0,0,0
N,0,1,2,1,1,0,1,0,3,3,3,1,2,3,2
P,2,4,2,2,2,1,0,0,1,6,0,2,6,2,4
Q,2,2,2,3,0,1,3,0,1,0,0,2,1,1,1
R,1,2,1,6,6,1,2,0,0,1,1,1,2,1,7
S,3,1,2,3,2,3,9,18,5,4,7,5,5,5,2
T,3,5,3,1,2,6,0,17,2,3,3,1,0,4,1
V,0,6,0,1,1,1,1,0,4,0,2,1,0,2,1
W,0,0,0,0,0,0,0,0,0,0,1,0,0,0,0
Y,4,1,0,1,1,5,1,0,0,1,3,2,1,1,3
